Case I: MDLXII
Case II: IV
Case III: XV
Case IV: MMMCDXXIX
Case V: CM
Case VI: DCCXXXV
Case VII: MMMDCXVI
Case VIII: MCC
Case IX: MMMDC
Case X: MMMCDXXIX
Case XI: MMMMCMLXIV
Case XII: MMMMCMXCIX
Case XIII: MMLXXXIX
Case XIV: MCCCLXXX
Case XV: CCXCIV
Case XVI: MMMDCCXLVI
Case XVII: MMMMCCVIII
Case XVIII: MCCCXL
Case XIX: CCCI
Case XX: CCXXXVIII
Case XXI: DCCVIII
Case XXII: MMCCCLIV
Case XXIII: MDCCCXCVIII
Case XXIV: MMMCCCXCVI
Case XXV: MMMDXIII
Case XXVI: CXVIII
Case XXVII: MMMCMXXXVII
Case XXVIII: MMMMDCCXII
Case XXIX: MMMMCDXVII
Case XXX: MMMMDCLXXXVI
Case XXXI: MMMMXXXI
Case XXXII: MMMCDXCVII
Case XXXIII: LXXVIII
Case XXXIV: MDCCCX
Case XXXV: DCLI
Case XXXVI: MMMMDCCXLIV
Case XXXVII: MMMMDXLIV
Case XXXVIII: MDCXLVI
Case XXXIX: MMMMDCXCIII
Case XL: MMVIII
Case XLI: DCCLXVI
Case XLII: MDLII
Case XLIII: MMMCMLX
Case XLIV: MMDCCLVIII
Case XLV: MMMMCCCXVIII
Case XLVI: MMMCCLXX
Case XLVII: MMMMCLXI
Case XLVIII: MCMXCII
Case XLIX: MMMDCCCLXXIX
Case L: MMLXXI
Case LI: MDCCCXXI
Case LII: MCCLXXXIV
Case LIII: MMMCDLI
Case LIV: MDCCC
Case LV: MMMDLXXV
Case LVI: MMMCDII
Case LVII: MMMMDCCCXXX
Case LVIII: MCDX
Case LIX: MMMMCCCXXI
Case LX: MCCCLXXXVII
Case LXI: MMMMDCCLXV
Case LXII: MMMMCMXXXIII
Case LXIII: MMMCXXXV
Case LXIV: MMMDCCXXVI
Case LXV: MMCCCLXXVII
Case LXVI: MDCLII
Case LXVII: MMDCXXXI
Case LXVIII: MMMMCMXC
Case LXIX: MMDCXCIII
Case LXX: MMXLVIII
Case LXXI: MMMMCII
Case LXXII: XLVII
Case LXXIII: CXLIV
Case LXXIV: MDLXVIII
Case LXXV: MMCCLXXXIV
Case LXXVI: CXVI
Case LXXVII: MMMMCDXXV
Case LXXVIII: CMLXXXI
Case LXXIX: DCXCIII
Case LXXX: CCCLXXXIV
Case LXXXI: MMCXCVI
Case LXXXII: MMCCIX
Case LXXXIII: DCLXXV
Case LXXXIV: MMMCMLXX
Case LXXXV: MMMDCXXX
Case LXXXVI: CL
Case LXXXVII: MMMDCCCXLIII
Case LXXXVIII: MMMCDXIX
Case LXXXIX: MDXXIV
Case XC: DCCCLXXVIII
Case XCI: MMMMCX
Case XCII: MDCCXCIV
Case XCIII: MMMMLXXXIV
Case XCIV: MMXXIII
Case XCV: MMDCCLXXXIX
Case XCVI: MMMMCDXVI
Case XCVII: MMCMXVII
Case XCVIII: MDCCXXXV
Case XCIX: MMMDCCLXXXIII
Case C: CMXCVI
Case CI: XCI
Case CII: MMMDCLXXVI
Case CIII: DII
Case CIV: MMDCXLIX
Case CV: MMMLXX
Case CVI: MMXIII
Case CVII: MMMDCCXCIII
Case CVIII: MMDCCCLXIV
Case CIX: MMMMCCCXCVI
Case CX: MCCCXXX
Case CXI: MMMMCLIV
Case CXII: DCCCXLVIII
